44444444444444444444444444444444444444444
47777777777777777777777777777777777777774
47666666666666666666666666666666666666774
47666666666666666666666666666666666666774
47007777777000000000000777770077770000774
47000000000000000000000777770077777000774
47777777777777777777777777766666667777774
47000000000000000000000077776666000000774
47000000000000000000000000007777700000774
47666666666666666666666666666666666666774
47000000000111111111110000000000000000774
47666666666666666666666666666666666666774
47000000000000001111111111111111000000774
47666666666666666666666666666666666666774
47666666666666666666666666666666666666774
47666666666666666666666666666666666666774
47666666666666666666666666666666666666774
47666666666666666666666666666666666666774
47000004444444444444444444000000000000774
47000000000888888888888000000000000000774
47666666666666666666666666666666666666774
47000000000000000008888888888888000000774
47000000000000000000000000000000000000774
47666666666666666666667777666666677776774
47666666666666677776666666666666677766774
47000000000000000000000007777000000005774
47222222222222222222222222222222222222774
47222222222222222222222222222222222222774
47222222222222222222222222222222222222774
47666666666666666666666666666666666666774
47777777777777777777777777777777777777774
44444444444444444444444444444444444444444