3333333333333333333333333333333333333333
3000000000000000000000000000000000000003
3000000000000000000000000000000000000003
3000000111111110000000111111111111111003
3000000000000000000000000000000000000003
3000000000000777700000000006666600000003
3066660000000000000000000000000000000003
3000000000000000000000001111111111000003
3000001111111111100000000000000000000003
3000000000000000000000000000000000000003
3000666666000000000000111111100000000003
3000000000000000000000000000000000000003
3007777000000000005000000000077770000003
3000000000000000000000000000000000000003
3000000000007777777000000000000000000003
3000000000000000000000000000000000000003
3000011111111111111111100000000000000003
3000000000000000000000000000000000000003
3000000077777777777777777770000000000003
3000000000000000000000000000000000000003
3000000000011111111100000000000000000003
3066666666000000000000000000000000000003
3000000000000000000000000666666600000003
3000000000000000000000000000000000000003
3000000001111111111111110000000000000003
3000000000000000000000000000000000000003
3000000000000000000000000000000000000003
3000000066666666666666660000000000000003
3000000000000000000000000000000000000003
3333333333333333333333333333333333333333