2222222222222222222222222222222222222222
2000000000000000000000200000000000000002
2000000000000000000000200000000000000002
2000000000000000000000200000000000000002
2000000000000000000000222222222222220002
2000000000000000000000200000000000000002
2000000000000000000000200000000000000002
2222222222222200000000200000000000000002
2000000000000200000000222222222222220002
2000000000000200000000000000000000000002
2000000000000200000000000000000000000002
2002222222222200000022222222222222222222
2000000000000200000002222222222222222222
2000000000000200000002222222222222222222
2000000000000200000000000000000000000002
2000000000000200000000000000000000000002
2000000000000200000002222222222222222222
2000000000000200000000222222222222222222
2000000000000200000000222222222222222222
2000000000000200000000222222222222222222
2000000000000200000000222222222222222222
2000000000000200000000222222222222222222
2000000000000200000000222222222222222222
2000000000000000000000222222222222222222
2000000000000000000000000000000000000002
2222222222222200000000000000000000000002
2000000000000200000000000000000000000002
2000000000000000000000000000000000000005
2000000000000000000000000000000000000002
2222222222222222222222222222222222222222