4444444444444444444444444444444444444444
4000000000000000000000000000000000000004
4000000000000000000000000000000000000004
4000000000000000000000000000000000000004
4000000000000000000000000000000000000004
4000000000000000000000000000000000000004
4000000000000000000000000000000000000004
4000000000000000000000000000000000000004
4000000000000000000000000000000000000004
4000000000000000000000000000000000000004
4000000000000000000000000000000000000004
4000000000000000000000000000000000000004
4000000000000000000000000000000000000004
4000000000000000000000000000000000000004
4000000000000000000000000000000000000004
4000000000000000000000000000000000000004
4000000000000000000000009000000000000004
4000000000000000000000000000000000000004
4000000000000000000000000000000000000004
4000000000000000000000000000000000000004
4000000000000000000000000000000000000004
4000000000000000000000000000000000000004
4000000000000000000000000000000000000004
4000000000000000000000000000000000000004
4000000000000000000000000000000000000004
4000000000000000000000000000000000000004
4000000000000000000000000000000000000004
4000000000000000000000000000000000000004
4000000000000000000000000000000000000004
4444444444444444444444444444444444444444