4444444444444444444444444444444444444444
4000000000000040000000000000000000000004
4000000000000000000000000000000000000004
4000000000000000000000000000000000000004
4000000000000000000000000000000000000004
4000000000000040000000000000000000000004
4444400004444440000000000444444000044444
4000000000000000000000000400000000000004
4000000000000000000000000000000000000004
4000000000000000000000000000000000000004
4000000000000000000000000000000000000004
4000000000000000000000000000000000000004
4000000000000000000000000400000000000004
4000000000000000000000000444444444444444
4444444444444400000004444444444444444444
4000000000000000000000000422222222222224
4000000000000000000000000422266666000024
4000000000000000000000000422666600000004
4000000000000000000000000426660000000005
4000000000000000000000000426600000000004
4000000000000000000000000426000000000004
4000000000000000000000000420000000000004
4444444444444440000000000400000000000004
4000000000000040000000000400000000000004
4000000000000000000000000000000000000004
4000000000000000000000000000000000000004
4000000000000000000000000000000000000004
4000000000000000000000000000000000000004
4000000000000040000000000000000000000004
4444444444444444444444444444444444444444